U,R,Y,U,G,I,B,G,Y,R,K,S,N,
K,G,S,K,B,R,I,S,K,B,U,G,I,
B,Y,I,I,I,I,Y,U,S,I,R,I,N,
I,R,I,U,Y,I,K,R,G,Y,I,I,K,
I,G,I,R,S,B,S,K,B,I,S,G,N,
Y,I,S,I,I,I,U,G,U,I,I,B,S,
R,I,I,U,I,G,Y,I,I,Y,I,K,N,
U,S,G,B,K,I,I,I,R,K,U,I,I,
B,K,U,Y,R,B,G,I,B,S,R,Y,N,
