G,I,B,K,U,R,S,I,B,K,U,Y,I
S,I,I,G,B,G,Y,I,G,S,B,I,K
R,B,K,I,S,U,K,I,I,R,I,I,R
Y,S,R,I,Y,R,I,K,I,I,U,S,G
U,G,U,Y,I,I,I,G,S,B,R,Y,U
K,I,I,I,B,S,I,Y,U,I,K,B,R
B,I,U,K,I,G,U,I,I,I,I,I,I
I,Y,B,I,R,K,Y,R,K,B,G,K
G,S,R,I,Y,S,U,B,G,S,R,Y,U